Row 17
column 21

=====================
=0000000000000000000=
=0000000000000000000=
=0000000000000000000=
=0000000000000000000=
=00000000000000*0**E=
=00000000000000=W====
=00000000000000======
=00000000000000======
=000000000000*0======
=000000000000=W======
=000000000000========
=000000000000========
=00000*0**0*0========
=*****=~==~=W========
=====================
=====================