Row 17
column 40
=**************************************=
====00000000000000000000000000000000000=
====00000000000000000000000000000000000=
====000**********WWWWW**************E**=
====000=================================
====*0000000000000000000000000000000000=
=====0000000000000000000000000000000000=
=====***0000000000000000000000000000000=
========00000000000***00********0000000=
========00000000000====T========0000000=
=000000000000000000000000000000000*0000=
=00000000000000000000000000000000000000=
=000000000000*00000000000000*0000000000=
=000000000000=0000000000000*=**********=
=00000000*000=000000000000*=============
=********=***=***~~*~~*~~*==============
========================================