Row 17
column 40

========================================
=0000000===000000=00000000=000000000=00=
=0000000===00*000=00000000=000*00*00=00=
=E=00000===*0=00*=00000000=000=**=**=00=
=0000000===00=000=00000000=000000000000=
=0000000===0*=*000000000000000000000000=
=0000000===00=000*****~~~W~*********000=
=0000000===00=***===================***=
=000000000000=000=000000000000000=0=000=
=0*000000000000*0=000000000000000=0=000=
=T=********W***=S=000000000000000=0=0*0=
==================000******S*****=0=*=0=
=000=0==0=0000000=000000000000000000000=
=0000000000000000=00000000000000000000*=
=0000000000000000=000000000000*00000000=
=**W*W**W*W****00=**0*******~~=***W****=
===============tS===t===================