Row 12
column 38

=************************************=
=000000000000000000000000000000000000=
=000000000000000000000000000000000000=
=000000000000000000000000000000000000=
=000000000000000000000000000000000000=
=000000000000000000000000000000000000=
=000000000000000000000000000000000000=
=000000000000000000000000000000000000=
=0000000000000000*0000000000000000000=
=***S***WWWWWWW**=**S**~~~~~~~***E***=
======================================
======================================