Row 21
column 45

=============================================
=00000000000000000000000=0000000000000000000=
=00000000000000000000000=00000000000000000S0=
=0000000**0000000000000*=******************t=
=0000000000000000000000000000000000000000000=
=0000000000000000000000000000000000000000000=
=0000000000000000000000000000000000000000000=
=00000000000000000000000000000**000000000000=
=00000**000000000000000000000000000000000000=
=0000000000000000**0000000000000000000**0000=
=0000000000000**0000000000000000000000000000=
=00000000000000000000000000*0000000000000000=
=00000000000000000000000000000000000000000S0=
=00000000000000000000000000000000000000000=t=
=00000000000000000000**0000000000000000000===
=00000000000000**00000000000000000000000*000=
=000000000000000000000000000*000000000000000=
=*****000000000000000000000000000**000000000=
=E====00000000000000000000000000000000000000=
======WWWWWWWWWWWWWWWWWWWWWWWWWWWWWWWWWWWWWW=
=============================================